UUU	F	Phe	Phenylalanine
UUC	F	Phe	Phenylalanine
UUA	L	Leu	Leucine
UUG	L	Leu	Leucine
CUU	L	Leu	Leucine
CUC	L	Leu	Leucine
CUA	L	Leu	Leucine
CUG	L	Leu	Leucine
AUU	I	Ile	Isoleucine
AUC	I	Ile	Isoleucine
AUA	I	Ile	Isoleucine
AUG	M	Met	Methionine (Start)
GUU	V	Val	Valine
GUC	V	Val	Valine
GUA	V	Val	Valine
GUG	V	Val	Valine
UCU	S	Ser	Serine
UCC	S	Ser	Serine
UCA	S	Ser	Serine
UCG	S	Ser	Serine
CCU	P	Pro	Proline
CCC	P	Pro	Proline
CCA	P	Pro	Proline
CCG	P	Pro	Proline
ACU	T	Thr	Threonine
ACC	T	Thr	Threonine
ACA	T	Thr	Threonine
ACG	T	Thr	Threonine
GCU	A	Ala	Alanine
GCC	A	Ala	Alanine
GCA	A	Ala	Alanine
GCG	A	Ala	Alanine
UAU	Y	Tyr	Tyrosine
UAC	Y	Tyr	Tyrosine
UAA	X	Stop	(Stop)
UAG	X	Stop	(Stop)
CAU	H	His	Histidine
CAC	H	His	Histidine
CAA	Q	Gln	Glutamine
CAG	Q	Gln	Glutamine
AAU	N	Asn	Asparagine
AAC	N	Asn	Asparagine
AAA	K	Lys	Lysine
AAG	K	Lys	Lysine
GAU	D	Asp	Aspartic acid
GAC	D	Asp	Aspartic acid
GAA	E	Glu	Glutamic acid
GAG	E	Glu	Glutamic acid
UGU	C	Cys	Cysteine
UGC	C	Cys	Cysteine
UGA	X	Stop	(Stop)
UGG	W	Trp	Tryptophan
CGU	R	Arg	Arginine
CGC	R	Arg	Arginine
CGA	R	Arg	Arginine
CGG	R	Arg	Arginine
AGU	S	Ser	Serine
AGC	S	Ser	Serine
AGA	R	Arg	Arginine
AGG	R	Arg	Arginine
GGU	G	Gly	Glycine
GGC	G	Gly	Glycine
GGA	G	Gly	Glycine
GGG	G	Gly	Glycine
